9153B9153B
803AAAABAA
806A86AC42
8294016912
AC292C542E
AF846FFF83
AFC5157FAA
AFFFAFFFEA
813FAFD512
A86FAFFFC2
EA956D5516
9029139143
AEAC2AAC52
A9296AC392
C446D456C6

0,0
9,14
EEESSSEESEEESESSSSSWSESSS